****************
* *       *   E*
* *  *    *  ***
*    *    *    *
*    *    *    *
*    *    *    *
*S   *         *
****************
